10
# # # # # # # # # #
. . # . # . . . . #
# . # . . . # # # #
# . # . # . # . # #
# . # . # . # . # #
# . # . # . # . # #
# . . . # . . . . . 
# . # . # . # . # #
# . # . # . # . # #
# # # # # # # # # #
